Christian | Jackson | C#
Max | Aiden | SQL
Anthony | Liam | Java
Joseph | Lucas | C#
Julian | Noah | C#
John | Mason | SQL
Colton | Ethan | C#
Levi | Caden | SQL
Muhammad | Jacob | Java
Isaiah | Logan | C#
Aaron | Jayden | C#
Tyler | Elijah | SQL
Charlie | Jack | C#
Adam | Luke | SQL
Parker | Michael | Java
Austin | Benjamin | C#
Thomas | Alexander | C#
Zachary | James | SQL
Nolan | Jayce | C#
Alex | Caleb | SQL
Ian | Connor | Java
Jonathan | William | C#
Christopher | Carter | C#
Cooper | Ryan | SQL
Hudson | Oliver | C#
Miles | Matthew | SQL
Adrian | Daniel | Java
Leo | Gabriel | C#
Blake | Henry | C#
Lincoln | Owen | SQL
Jordan | Grayson | C#
Tristan | Dylan | SQL
Jason | Landon | Java
Josiah | Isaac | C#
Xavier | Nicholas | C#
Camden | Wyatt | SQL
Chase | Nathan | C#
Declan | Andrew | SQL
Carson | Cameron | Java
Colin | Dominic | C#
Brody | Joshua | C#
Asher | Eli | SQL
Jeremiah | Sebastian | C#
Micah | Hunter | SQL
Easton | Brayden | Java
Xander | David | C#
Ryder | Samuel | C#
Nathaniel | Evan | SQL
Elliot | Gavin | C#
Sean | Cole | SQL